.*..******..**.*.*.*
*****.*....***.**..*
.*..*..*.*****..*.**
..*.**.*...**.*..***
....*....*.****...**
..**.*.*...*****..*.
.....*..*.***.***..*
**.*.***.*.*..**.*..
**.**..***.*.*......
**...*...**.*..***.*
....****.*..***...**
*...*.*.***..*.*.***
**.*...*..**..*....*
..**.*....***.*.**..
*..***.*......**.**.
*.*..****.*..*....**
.**..**.*...*.***..*
***.*.****.**..*..*.
..*...**..**.*..*...
*.*.*..**..*..***.**
**..**.*.*****..*.*.
.*...*.*.*.....**..*
..**..***...**.***.*
..******...**.**...*
***..*...*..*.**...*
..**.**.*...**.**.*.
.**.*.**.*.*......*.
***.*.*.***.*...*...
****..*.**.*...***.*
.**.**.*...**..**..*
..**..****.****.*.*.
****..*.**...*...**.
***.*..******...*.*.
.*.**.**...*****.*..
*****...*.*.***.*.**
**....*..*.***.***.*
**.*...*..*..***.*.*
..**.***...***......
**.*.***..********..
...*....*...*..*..**
**.*****..*..*..*.*.
**.**..*.***.*****..
*..*..*..**.....*.**
*.**.*..**..*.*.....
..****...*..*.*.....
*....****.*..*.*.*..
*.*....***.**.*....*
..*...**..*.*******.
....**...*.***..**.*
....***.**..*.**.*.*
**........**.*.....*
**....***.*.***.*...
****.....**.**.*..*.
.****.......**.*..**
.**...*.*..****.****
*****.*..**.....*.*.
**.***.***.***.**.**
....*.*.***..*.*...*
*.....*.*.***..*.*..
*...*.**.*..*..**.**
.**..*.*...*.*******
*..**.*...*....*****
**....*.****...*..**
..*.*.*....****..*.*
*.***.***.*.**.*.***
...*..*.....*..****.
...**.*...*........*
*.**.*.**.*.**.*****
*.*.*.......*.***.**
*......**..***.*....
..**...****.***.....
*.*.**.*...*..**..**
****.*.**...*****.*.
**.**..**....*.***..
***.*...**..****....
.*..****...***.....*
***..*****.*.....**.
**..*.*.....**.*...*
*.*.*.......***.*..*
...*....*...*.**.*..
*...*.*.*.*.......*.
*..*..*....*.....***
**...***..*.***..*.*
.*...*.*...**.*...*.
.**.**..****.*.*.***
.*..****.**..***...*
*..*.**..**.***.**.*
.*...*....*..***.***
...**.*.**..***.**..
*.*.*...**.***.*..*.
*.........*...**.**.
**...*.****.*...**..
.**....*..*.*.......
**.*.*****.***.***..
****..**..*.**.....*
**.***..**.*.**...**
*..***.**.*.*..**..*
*******...****......
**.*..**..**..*..*..
*.*...*..*****.**.*.
..*.**.*.***.*.***.*
**..**.***...*...*..
*.*..**...**..*.*.**
.**.*...**.**..*...*
*.*****..**......**.
.*...*.*...***......
..***....**.*..**..*
.**...*..**.**....*.
***.*.*.*..*.*..**.*
**...**.*.**.*****.*
*.*.*..**.*.*.....**
*.*.*..**.*..****...
.....**..*..**.*...*
...**.....**.**....*
*.*.....***...**.***
*..*..**.**.*....*..
**.***..********..**
..*..*.*..*.**.*..**
...*.*..**.*.*..*..*
**..*.....***..*****
.*****.**.*.*..***..
.*.****.*.*...***...
.**.***..*.**......*
*...*...*.*..*.***.*
.*.*...*.......****.
**.***..***.*..****.
.***.*...*..*..**..*
.*..**.*.**....*...*
.***....***.****.**.
***..*...*..***..**.
...**..*.**...*.*..*
..*.....***.*..*....
***.*...***.....****
*.***.*....*.***.*..
....**.**.*..**.*.*.
**.*.*..**....**.*..
*.**.*.....*.**..*..
**..***.**..**....**
...*.*..*.**********
***....*...******.*.
....***.*.**...**...
.*.....*..*...****..
**.*..***..*.*..*.*.
****..*..**.*..*.*.*
..*..***.**.*.***...
****.**.**....*.*.**
...****.*.*.****....
...******.**..***.*.
**.***...*.**.*****.
***..*.*...**..**.**
.**.****..***..*..*.
.*..*..***..*****..*
.....**..*...****...
.*.*******...*..*.*.
.****.*..****.**..*.
.*.**.*..*..*.*.***.
*.*.*..*.**.*.**..**
..*..****..***..**..
..******.*..*.***...
....***..*..**.*.*.*
..*.*.**.**..******.
.*.*.***...**.*....*
...**.*...*......***
*****.*.*.**..*...**
**.**......**.*.***.
**..*.....*.***.**..
.*.***..*....***.**.
.*****..*..*.*...*..
****..*.*.*...*.*...
*..*.**..*****...*.*
.**.*....*.***...***
**.*..*....*.**....*
*..*...*.*....*.....
**....*******.***..*
..***..*..*.*.***..*
**.*.*.*.*..****..**
..**.....**.**...*.*
.*****.*.*..........
*.*...***.*.*.**.***
*****.****...*..**.*
...*.*.*.***.**.*.*.
..**.*...*.*.**..*..
*.*..***..**..*.*.*.
*.**..*..***.*.***.*
....*..***.....*.*.*
..**.**...*.*.**.*..
...*..**..***.**....
.**..*********.*..**
****.**..**......***
..********...**..***
